枯叶市
50,30
./0/空地,#/7/岩石,*/2/水域,^/3/草地,%/4/商店,&/5/医院,$/1/通往其他地区的出口
24/0/4/24/29,48/8/7/0/16
56/28/100,57/14/100,58/31/100,61/9/100,60/22/100,62/18/100,61/38/100,63/54/100,64/45/100

*#^^^^^^^^^^^^^^^^^^^^##$#^^^####################
*#^^###################..########################
*#^^#.....#&&&&&#.....#..#....#............######
*####.....#&&&&&#.....#..#....#..#####.....######
*#**###..####..########..######............######
*#**#....................................########
*#**#............................#####...########
*#********************...........#...#...##.....#
*#********************...........#...#...##.....$
*#********************...........#####...##^^^^^#
*#**..#######..#######......#######......##^^^^^#
*#**..#.....#..#@@@@@#......#%%%%%#########^^^^^#
*#**..#.....#..#@@@@@#......#%%%%%#........^^^^^#
*#**..##..###..###..##......###..##........^^^^^#
*#**.......................................^^^^^#
*#**........................#######***...***#****
*#**....######..######^^....#.....#***...***#****
*#**....#............#^^....###..##***...***#****
*#**....#............#^^***........***...***#****
*#**....##############^^***........***...***#****
*#************************************...***#****
*#************************************...***#****
*#************************************...***#****
*#***********************................***#****
*#**#####################................####****
*#***********************###..##************#****
*#***********************#.....#************#****
*#***********************#######************#****
*#***********************************************
*#***********************************************
3722222222222222222222771722277777777777777777777
3722777777777777777777700777777777777777777777777
3722700000755555700000700700007000000000000777777
3777700000755555700000700700007007777700000777777
3733777007777007777777700777777000000000000777777
3733700000000000000000000000000000000000077777777
3733700000000000000000000000000007777700077777777
3733333333333333333333000000000007000700077000007
3733333333333333333333000000000007000700077000001
3733333333333333333333000000000007777700077222227
3733007777777007777777000000777777700000077222227
3733007000007007666667000000744444777777777222227
3733007000007007666667000000744444700000000222227
3733007700777007770077000000777007700000000222227
3733000000000000000000000000000000000000000222227
3733000000000000000000000000777777733300033373333
3733000077777700777777220000700000733300033373333
3733000070000000000007220000777007733300033373333
3733000070000000000007223330000000033300033373333
3733000077777777777777223330000000033300033373333
3733333333333333333333333333333333333300033373333
3733333333333333333333333333333333333300033373333
3733333333333333333333333333333333333300033373333
3733333333333333333333333000000000000000033373333
3733777777777777777777777000000000000000077773333
3733333333333333333333333777007733333333333373333
3733333333333333333333333700000733333333333373333
3733333333333333333333333777777733333333333373333
3733333333333333333333333333333333333333333333333
3733333333333333333333333333333333333333333333333
1122222222222222222222113122211111111111111111111
1122111111111111111111100111111111111111111111111
1122100000155555100000100100001000000000000111111
1111100000155555100000100100001001111100000111111
1111111001111001111111100111111000000000000111111
1111100000000000000000000000000000000000011111111
1111100000000000000000000000000001111100011111111
1111111111111111111111000000000001000100011000001
1111111111111111111111000000000001000100011000003
1111111111111111111111000000000001111100011222221
1111001111111001111111000000111111100000011222221
1111001000001001666661000000144444111111111222221
1111001000001001666661000000144444100000000222221
1111001100111001110011000000111001100000000222221
1111000000000000000000000000000000000000000222221
1111000000000000000000000000111111111100011111111
1111000011111100111111220000100000111100011111111
1111000010000000000001220000111001111100011111111
1111000010000000000001221110000000011100011111111
1111000011111111111111221110000000011100011111111
1111111111111111111111111111111111111100011111111
1111111111111111111111111111111111111100011111111
1111111111111111111111111111111111111100011111111
1111111111111111111111111000000000000000011111111
1111111111111111111111111000000000000000011111111
1111111111111111111111111111001111111111111111111
1111111111111111111111111100000111111111111111111
1111111111111111111111111111111111111111111111111
1111111111111111111111111111111111111111111111111
1111111111111111111111111111111111111111111111111



