真新镇
60,20
./0/空地,#/7/岩石,*/3/水域,^/2/草地,%/4/商店,&/5/医院,$/1/出口,@/6/宝可梦中心
25/0/1/27/25
1/1/200,2/1/200,5/4/250,4/7/200,5/10/200,6/13/200,8/16/100,9/19/100,12/25/100,11/27/200
#########################$#################################
#^^^^^^^^^^^^^^^^^^^^^^#...#.......................^^^^^^##
#^^^^^^^^^^^^^^^^^^^^^^#...#.......................^^^^^^##
#^^^^^^^^^^^^^^^^^^^^^^#...#....#######...########.^^^^^^##
#^^^^^^^^^^^^^^^^^^^^^^#...#....#.....#...#%%%%%%#.^^^^^^##
#^^^^^^^^^^^^^^^^^^^^^^#...#....#.....#...#%%%%%%#.^^^^^^##
#^^^^^^^^^^^^^^^^^^^^^^#...#....##..###...###..###.^^^^^^##
#########....###########...#######..#########..######..####
#.........................................................#
#.........................................................#
########################...#######..#########..######..####
#**********************#...#..............................#
#**********************#...#..............................#
#**********************#...#.#####..######..######..#####.#
#**********************#...#.#...........#..#&&&&&&&&&&&#.#
#**********************#...#.#...........#..#&&&&&&&&&&&#.#
#**********************#...#.#############..#############.#
#**********************#...#..............................#
#**********************#...#..............................#
###########################################################
77777777777777777777777771777777777777777777777777777777777
72222222222222222222222700070000000000000000000000022222277
72222222222222222222222700070000000000000000000000022222277
72222222222222222222222700070000777777700077777777022222277
72222222222222222222222700070000700000700074444447022222277
72222222222222222222222700070000700000700074444447022222277
72222222222222222222222700070000770077700077700777022222277
77777777700007777777777700077777770077777777700777777007777
70000000000000000000000000000000000000000000000000000000007
70000000000000000000000000000000000000000000000000000000007
77777777777777777777777700077777770077777777700777777007777
73333333333333333333333700070000000000000000000000000000007
73333333333333333333333700070000000000000000000000000000007
73333333333333333333333700070777770077777700777777557777707
73333333333333333333333700070700000000000700755555555555707
73333333333333333333333700070700000000000700755555555555707
73333333333333333333333700070777777777777700777777777777707
73333333333333333333333700070000000000000000000000000000007
73333333333333333333333700070000000000000000000000000000007
77777777777777777777777777777777777777777777777777777777777
11111111111111111111111113111111111111111111111111111111111
12222222222222222222222100010000000000000000000000022222211
12222222222222222222222100010000000000000000000000022222211
12222222222222222222222100010000111111100011111111022222211
12222222222222222222222100010000100000100014444441022222211
12222222222222222222222100010000100000100014444441022222211
12222222222222222222222100010000110011100011100111022222211
11111111100001111111111100011111110011111111100111111001111
10000000000000000000000000000000000000000000000000000000001
10000000000000000000000000000000000000000000000000000000001
11111111111111111111111100011111110011111111100111111001111
11111111111111111111111100010000000000000000000000000000001
11111111111111111111111100010000000000000000000000000000001
11111111111111111111111100010111110011111100111111001111101
11111111111111111111111100010100000000000100155555555555101
11111111111111111111111100010100000000000100155555555555101
11111111111111111111111100010111111111111100111111111111101
11111111111111111111111100010000000000000000000000000000001
11111111111111111111111100010000000000000000000000000000001
11111111111111111111111111111111111111111111111111111111111