玉虹市
50,30
./0/空地,#/7/岩石,*/3/水域,^/2/草地,%/4/商店,&/5/医院,$/1/通往其他地区的出口,@/6/宝可梦中心
48/10/4/0/19
40/61/100,36/62/100,50/62/100,43/63/100,48/65/100,54/63/100,24/68/100,18/64/100
#################################################
#################################################
##%%%%%%%%#^^^^^^^^^^^^^^^^^^^^^^^^^^^^^^^^^^####
##%%%%%%%%#^^^^^^^^^^^^^^^^^^^^^^^^^^^^^^^^^^####
##%%%%%%%%######...######.................^^^####
##%%%%%%%%#....#...#....#.####.####.####..^^^####
##%%%%%%%%#....#...#....#.#..#.#..#.#&&#..^^^####
##%%%%%%%%#....#...#....#.#..#.#..#.#&&#..^^^####
#####..#########...##..##.####.####.#..#..^^^####
##..............................................#
##..............................................$
##..............................................#
##.........***.#######.#####...####.####...######
##.........***.#.....#.#@@@#...#..#.#..#...######
##.........***.##..###.#...#...####.####...######
##.........***...............................####
##...........................................####
##...........................................####
#............................................####
########.################...####.####.####...####
##.....#.#.........#....#...#..#.#..#.#..#...####
##.....#.#.........#....#...#..#.#..#.#..#...####
####..##.#####..#########...####.#..#.####...####
##...........................................####
##...........................................####
######..#########............................####
##^^^^^^^^^^^^^^^^^^^^^^^^^^^^^^^^^^^^^^^^^^^^^##
##^^^^^^^^^^^^^^^^^^^^^^^^^^^^^^^^^^^^^^^^^^^^^##
#################################################
#################################################
7777777777777777777777777777777777777777777777777
7777777777777777777777777777777777777777777777777
7744444444722222222222222222222222222222222227777
7744444444722222222222222222222222222222222227777
7744444444777777000777777000000000000000002227777
7744444444700007000700007077770777707777002227777
7744444444700007000700007070070700707557002227777
7744444444700007000700007070070700707557002227777
7777700777777777000770077077770777707007002227777
7700000000000000000000000000000000000000000000007
7700000000000000000000000000000000000000000000001
7700000000000000000000000000000000000000000000007
7700000000033307777777077777000777707777000777777
7700000000033307000007076667000700707007000777777
7700000000033307700777070007000777707777000777777
7700000000033300000000000000000000000000000007777
7700000000000000000000000000000000000000000007777
7700000000000000000000000000000000000000000007777
7000000000000000000000000000000000000000000007777
7777777707777777777777777000777707777077770007777
7700000707000000000700007000700707007070070007777
7700000707000000000700007000700707007070070007777
7777007707777700777777777000777707007077770007777
7700000000000000000000000000000000000000000007777
7700000000000000000000000000000000000000000007777
7777770077777777700000000000000000000000000007777
7722222222222222222222222222222222222222222222277
7722222222222222222222222222222222222222222222277
7777777777777777777777777777777777777777777777777
7777777777777777777777777777777777777777777777777
1111111111111111111111111111111111111111111111111
1111111111111111111111111111111111111111111111111
1144444444122222222222222222222222222222222221111
1144444444122222222222222222222222222222222221111
1144444444111111000111111000000000000000002221111
1144444444100001000100001011110111101111002221111
1144444444100001000100001010010100101551002221111
1144444444100001000100001010010100101551002221111
1111100111111111000110011011110111101001002221111
1100000000000000000000000000000000000000000000001
1100000000000000000000000000000000000000000000003
1100000000000000000000000000000000000000000000001
1100000000011101111111011111000111101111000111111
1100000000011101000001016661000100101001000111111
1100000000011101100111010001000111101111000111111
1100000000011100000000000000000000000000000001111
1100000000000000000000000000000000000000000001111
1100000000000000000000000000000000000000000001111
1000000000000000000000000000000000000000000001111
1111111101111111111111111000111101111011110001111
1100000101000000000100001000100101001010010001111
1100000101000000000100001000100101001010010001111
1111001101111100111111111000111101001011110001111
1100000000000000000000000000000000000000000001111
1100000000000000000000000000000000000000000001111
1111110011111111100000000000000000000000000001111
1122222222222222222222222222222222222222222222211
1122222222222222222222222222222222222222222222211
1111111111111111111111111111111111111111111111111
1111111111111111111111111111111111111111111111111