深灰市
50,29
./0/空地,#/7/岩石,^/2/草地,%/4/商店,&/5/医院,$/1/通往其他地区的出口,@/6/宝可梦中心
24/28/1/28/0,48/13/3/0/17
29/39/100,27/42/100,32/45/100,32/46/100,27/50/100,33/33/100,34/24/100,34/9/100,33/3/100,31/15/100
^^^^^^^^^^^^^^^^^^^^^^^^^^^^^^^^^^^^^^^^^^^^^^^^^
^^^^#############################################
####...^^^^^^#........#.......#^^^^^^^^^^^^^^^^^#
####...^^^^^^#........#.......#^^^^^^^^^^^^^^^^^#
####...^^^^^^#........#.......#^^^^^^^^^^^^^^^^^#
####...^^^^^^#........####..###^^^^^^^^^^^^^^^^^#
####...^^^^^^#........#........^^^^^^^^^^^^^^^^^#
##########..####..#####...#############...#######
####.........................................####
####.....^^^^^^^^^^^^^.......................####
####.....^^^^^^^^^^^^^.........######.......#####
####.....^^^^^^^^^^^^^.........#....#.......#####
####...........................#..###.......#####
####............................................$
####......##########.......######...............#
####......#........#.......#%%%%#...........#####
####......#........#..#....#%%%%#...........#####
####......####..####..#....##..##...........#####
####..................#.....................#####
#######################.....................#####
####........#&&&&&&#........####...######...#^^^^
####........#&&&&&&#.......#^^^^^^^^^^^^^#..#^^^^
####........###...##.......#^^^^^^^^^^^^^#..#^^^^
####..#####.................####...######...#^^^^
####..#@@@#.................................#^^^^
####..#.....................................##^^^
####################^^^...^^^^^^^^^^^^^^^^^^#####
^^^^^^^^^^^^^^^^^^^^^^^...^^^^^^^^^^^^^^^^^^^^###
########################$########################
2222222222222222222222222222222222222222222222222
2222777777777777777777777777777777777777777777777
7777000222222700000000700000007222222222222222227
7777000222222700000000700000007222222222222222227
7777000222222700000000700000007222222222222222227
7777000222222700000000777700777222222222222222227
7777000222222700000000700000000222222222222222227
7777777777007777007777700077777777777770007777777
7777000000000000000000000000000000000000000007777
7777000002222222222222000000000000000000000007777
7777000002222222222222000000000777777000000077777
7777000002222222222222000000000700007000000077777
7777000000000000000000000000000700777000000077777
7777000000000000000000000000000000000000000000001
7777000000777777777700000007777770000000000000007
7777000000700000000700000007444470000000000077777
7777000000700000000700700007444470000000000077777
7777000000777700777700700007700770000000000077777
7777000000000000000000700000000000000000000077777
7777777777777777777777700000000000000000000077777
7777000000007555555700000000777700077777700072222
7777000000007555555700000007222222222222270072222
7777000000007770007700000007222222222222270072222
7777007777700000000000000000777700077777700072222
7777007666700000000000000000000000000000000072222
7777007000000000000000000000000000000000000077222
7777777777777777777722200022222222222222222277777
2222222222222222222222200022222222222222222222777
7777777777777777777777771777777777777777777777777
2222222222222222222222222222222222222222222222222
2222111111111111111111111111111111111111111111111
1111000222222100000000100000001222222222222222221
1111000222222100000000100000001222222222222222221
1111000222222100000000100000001222222222222222221
1111000222222100000000111100111222222222222222221
1111000222222100000000100000000222222222222222221
1111111111001111001111100011111111111110001111111
1111000000000000000000000000000000000000000001111
1111000002222222222222000000000000000000000001111
1111000002222222222222000000000111111000000011111
1111000002222222222222000000000100001000000011111
1111000000000000000000000000000100111000000011111
1111000000000000000000000000000000000000000000003
1111000000111111111100000001111110000000000000001
1111000000100000000100000001444410000000000011111
1111000000100000000100100001444410000000000011111
1111000000111100111100100001100110000000000011111
1111000000000000000000100000000000000000000011111
1111111111111111111111100000000000000000000011111
1111000000001555555100000000111100011111100012222
1111000000001555555100000001222222222222210012222
1111000000001110001100000001222222222222210012222
1111001111100000000000000000111100011111100012222
1111001666100000000000000000000000000000000012222
1111001000000000000000000000000000000000000011222
1111111111111111111122200022222222222222222211111
2222222222222222222222200022222222222222222222111
1111111111111111111111113111111111111111111111111



