枯叶市
50,30
./0/空地,#/1/岩石,*/2/水域,^/3/草地,%/0/商店,&/0/医院,$/0/通往其他地区的出口
24/0/4/24/29,48/8/7/0/16

*#^^^^^^^^^^^^^^^^^^^^##$#^^^####################
*#^^###################..########################
*#^^#.....#&&&&&#.....#..#....#............######
*####.....#&&&&&#.....#..#....#..#####.....######
*#**###..####..########..######............######
*#**#....................................########
*#**#............................#####...########
*#********************...........#...#...##.....#
*#********************...........#...#...##.....$
*#********************...........#####...##^^^^^#
*#**..#######..#######......#######......##^^^^^#
*#**..#.....#..#@@@@@#......#%%%%%#########^^^^^#
*#**..#.....#..#@@@@@#......#%%%%%#........^^^^^#
*#**..##..###..###..##......###..##........^^^^^#
*#**.......................................^^^^^#
*#**........................#######***...***#****
*#**....######..######^^....#.....#***...***#****
*#**....#............#^^....###..##***...***#****
*#**....#............#^^***........***...***#****
*#**....##############^^***........***...***#****
*#************************************...***#****
*#************************************...***#****
*#************************************...***#****
*#***********************................***#****
*#**#####################................####****
*#***********************###..##************#****
*#***********************#.....#************#****
*#***********************#######************#****
*#***********************************************
*#***********************************************
5722222222222222222222771722222222222222222222222
5722777777777777777777700777722222222222222222222
5722700000711111700000700700007000000000000222222
5777700000711111700000700700007007777700000222222
5755777007777007777777700777777000000000000222222
5755700000000000000000000000000000000000077222222
5755700000000000000000000000000007777700077222222
5755555555555555555555000000000007000700077000007
5755555555555555555555000000000007000700077000001
5755555555555555555555000000000007777700077222227
5755007777777007777777000000777777700000077222227
5755007000007007111117000000711111777777777222227
5755007000007007111117000000711111700000000222227
5755007700777007770077000000777007700000000222227
5755000000000000000000000000000000000000000222227
5755000000000000000000000000444444455500055575555
5755000044444400444444220000400000455500055575555
5755000040000000000004220000444004455500055575555
5755000040000000000004225550000000055500055575555
5755000044444444444444225550000000055500055575555
5755555555555555555555555555555555555500055575555
5755555555555555555555555555555555555500055575555
5755555555555555555555555555555555555500055575555
5755555555555555555555555000000000000000055575555
5755777777777777777777777000000000000000077775555
5755555555555555555555555777007755555555555575555
5755555555555555555555555700000755555555555575555
5755555555555555555555555777777755555555555575555
5755555555555555555555555555555555555555555555555
5755555555555555555555555555555555555555555555555
1122222222222222222222113122211111111111111111111
1122111111111111111111100111111111111111111111111
1122100000155555100000100100001000000000000111111
1111100000155555100000100100001001111100000111111
1111111001111001111111100111111000000000000111111
1111100000000000000000000000000000000000011111111
1111100000000000000000000000000001111100011111111
1111111111111111111111000000000001000100011000001
1111111111111111111111000000000001000100011000003
1111111111111111111111000000000001111100011222221
1111001111111001111111000000111111100000011222221
1111001000001001666661000000144444111111111222221
1111001000001001666661000000144444100000000222221
1111001100111001110011000000111001100000000222221
1111000000000000000000000000000000000000000222221
1111000000000000000000000000111111111100011111111
1111000011111100111111220000100000111100011111111
1111000010000000000001220000111001111100011111111
1111000010000000000001221110000000011100011111111
1111000011111111111111221110000000011100011111111
1111111111111111111111111111111111111100011111111
1111111111111111111111111111111111111100011111111
1111111111111111111111111111111111111100011111111
1111111111111111111111111000000000000000011111111
1111111111111111111111111000000000000000011111111
1111111111111111111111111111001111111111111111111
1111111111111111111111111100000111111111111111111
1111111111111111111111111111111111111111111111111
1111111111111111111111111111111111111111111111111
1111111111111111111111111111111111111111111111111



