浅红镇
49,29
./0/空地,#/7/岩石,*/3/水域,^/2/草地,%/4/商店,&/5/医院,$/1/通往其他地区的出口,@/6/宝可梦中心
0/16/5/48/8,10/28/8/23/0
76/31/100,78/6/100,81/3/100,83/26/100,84/31/100,86/9/100,89/36/100,89/56/100,91/54/100
#################################################
######^^^^^^#######.#......######################
##^^^^^^^^^^#######.#......######^^^^^^^^^^^#####
##^^##########^^#^^.#############^^^^^^^^^^^#####
##^^#******###^^#^^#........##.....^^^^^^^^^^####
##^^#******###^^#^^#........##.....^^^^^^^^^^^###
##^^#...^^^^##^^^^^#...........................##
##^^^...^^^^^^^^^^^#...............##############
##^^^#######^^^^^^^#....########...^^^^^^^^^^^###
##^^^#%%%%%#########....#......#...^^^^^^^^^^^###
##^^^#%%%%%#............#......#...^^^^^^^^^^^###
##^^^##..###........^^^####..###....########...##
##..................^^^#...........#********#..##
####################^^^#...........#********#..##
######************##^^^#...........#********#..##
######************######.......########........##
$..............................#@@@@@@#........##
#..##########################..#@@@@@@#######..##
#..##########################..#@@@@@@#.....#..##
#..##########################..###..#########..##
#..#.#........#.....#.#######..................##
#..#.#........###..##.#&&&&&#....^^^^^^^^......##
#..#.####...###.......###..##....^^^^^^^^......##
#..#.............................^^^^^^^^......##
#..#######.....#############...................##
#..............#######.........................##
#######........#######^^^^^^^^^^^^^^^^^^^^^^^^^##
#######........##################################
##########$######################################
7777777777777777777777777777777777777777777777777
7777772222227777777070000007777777777777777777777
7722222222227777777070000007777772222222222277777
7722777777777722722077777777777772222222222277777
7722733333377722722700000000770000022222222227777
7722733333377722722700000000770000022222222222777
7722700022227722222700000000000000000000000000077
7722200022222222222700000000000000077777777777777
7722277777772222222700007777777700022222222222777
7722274444477777777700007000000700022222222222777
7722274444470000000000007000000700022222222222777
7722277007770000000022277770077700007777777700077
7700000000000000000022270000000000073333333370077
7777777777777777777722270000000000073333333370077
7777773333333333337722270000000000073333333370077
7777773333333333337777770000000777777770000000077
1000000000000000000000000000000766666670000000077
7007777777777777777777777777700766666677777770077
7007777777777777777777777777700766666670000070077
7007777777777777777777777777700777007777777770077
7007070000000070000070777777700000000000000000077
7007070000000077700770755555700002222222200000077
7007077770007770000000777007700002222222200000077
7007000000000000000000000000000002222222200000077
7007777777000007777777777777000000000000000000077
7000000000000007777777000000000000000000000000077
7777777000000007777777222222222222222222222222277
7777777000000007777777777777777777777777777777777
7777777777177777777777777777777777777777777777777
1111111111111111111111111111111111111111111111111
1111112222221111111010000001111111111111111111111
1122222222221111111010000001111112222222222211111
1122111111111122122011111111111112222222222211111
1122111111111122122100000000110000022222222221111
1122111111111122122100000000110000022222222222111
1122100022221122222100000000000000000000000000011
1122200022222222222100000000000000011111111111111
1122211111112222222100001111111100022222222222111
1122214444411111111100001000000100022222222222111
1122214444410000000000001000000100022222222222111
1122211001110000000022211110011100001111111100011
1100000000000000000022210000000000011111111110011
1111111111111111111122210000000000011111111110011
1111111111111111111122210000000000011111111110011
1111111111111111111111110000000111111110000000011
3000000000000000000000000000000166666610000000011
1001111111111111111111111111100166666611111110011
1001111111111111111111111111100166666610000010011
1001111111111111111111111111100111001111111110011
1001010000000010000010111111100000000000000000011
1001010000000011100110155555100002222222200000011
1001011110001110000000111001100002222222200000011
1001000000000000000000000000000002222222200000011
1001111111000001111111111111000000000000000000011
1000000000000001111111000000000000000000000000011
1111111000000001111111222222222222222222222222211
1111111000000001111111111111111111111111111111111
1111111111311111111111111111111111111111111111111