真新镇
60,20
./0/空地,#/1/岩石,*/2/水域,^/3/草地,%/0/商店,&/0/医院,★/0/通往其他地区的出口
(25,0) 

#########################$#################################
#^^^^^^^^^^^^^^^^^^^^^^#...#.......................^^^^^^##
#^^^^^^^^^^^^^^^^^^^^^^#...#.......................^^^^^^##
#^^^^^^^^^^^^^^^^^^^^^^#...#....#######...########.^^^^^^##
#^^^^^^^^^^^^^^^^^^^^^^#...#....#.....#...#%%%%%%#.^^^^^^##
#^^^^^^^^^^^^^^^^^^^^^^#...#....#.....#...#%%%%%%#.^^^^^^##
#^^^^^^^^^^^^^^^^^^^^^^#...#....##..###...###..###.^^^^^^##
#########....###########...#######..#########..######..####
#.........................................................#
#.........................................................#
########################...#######..#########..######..####
#**********************#...#..............................#
#**********************#...#..............................#
#**********************#...#.#####..######..######..#####.#
#**********************#...#.#...........#..#&&&&&&&&&&&#.#
#**********************#...#.#...........#..#&&&&&&&&&&&#.#
#**********************#...#.#############..#############.#
#**********************#...#..............................#
#**********************#...#..............................#
###########################################################
88888888888888888888888881888888888888888888888888888888888
82222222222222222222222800080000000000000000000000022222288
82222222222222222222222800080000000000000000000000022222288
82222222222222222222222800080000888888800088888888022222288
82222222222222222222222800080000800000800080000008022222288
82222222222222222222222800080000800000800080000008022222288
82222222222222222222222800080000880088800088800888022222288
88888888800008888888888800088888880088888888800888888008888
80000000000000000000000000000000000000000000000000000000008
80000000000000000000000000000000000000000000000000000000008
88888888888888888888888800088888880088888888800888888008888
83333333333333333333333800080000000000000000000000000000008
83333333333333333333333800080000000000000000000000000000008
83333333333333333333333800080888880088888800888888008888808
83333333333333333333333800080800000000000800800000000000808
83333333333333333333333800080800000000000800800000000000808
83333333333333333333333800080888888888888800888888888888808
83333333333333333333333800080000000000000000000000000000008
83333333333333333333333800080000000000000000000000000000008
88888888888888888888888888888888888888888888888888888888888
11111111111111111111111113111111111111111111111111111111111
12222222222222222222222100010000000000000000000000022222211
12222222222222222222222100010000000000000000000000022222211
12222222222222222222222100010000111111100011111111022222211
12222222222222222222222100010000100000100014444441022222211
12222222222222222222222100010000100000100014444441022222211
12222222222222222222222100010000110011100011100111022222211
11111111100001111111111100011111110011111111100111111001111
10000000000000000000000000000000000000000000000000000000001
10000000000000000000000000000000000000000000000000000000001
11111111111111111111111100011111110011111111100111111001111
11111111111111111111111100010000000000000000000000000000001
11111111111111111111111100010000000000000000000000000000001
11111111111111111111111100010111110011111100111111001111101
11111111111111111111111100010100000000000100155555555555101
11111111111111111111111100010100000000000100155555555555101
11111111111111111111111100010111111111111100111111111111101
11111111111111111111111100010000000000000000000000000000001
11111111111111111111111100010000000000000000000000000000001
11111111111111111111111111111111111111111111111111111111111