深灰市
49，29
./0/空地，#/1/岩石，▶/2/水域，^/3草地，%/0/商店，&/0/医院，$/0/通往其他地区的出口
24/28/1/28/0，48/13/3/0/-17

^^^^^^^^^^^^^^^^^^^^^^^^^^^^^^^^^^^^^^^^^^^^^^^^^
^^^^#############################################
####...^^^^^^#........#.......#^^^^^^^^^^^^^^^^^#
####...^^^^^^#........#.......#^^^^^^^^^^^^^^^^^#
####...^^^^^^#........#.......#^^^^^^^^^^^^^^^^^#
####...^^^^^^#........####..###^^^^^^^^^^^^^^^^^#
####...^^^^^^#........#........^^^^^^^^^^^^^^^^^#
##########..####..#####...#############...#######
####.........................................####
####.....^^^^^^^^^^^^^.......................####
####.....^^^^^^^^^^^^^.........######.......#####
####.....^^^^^^^^^^^^^.........#....#.......#####
####...........................#..###.......#####
####............................................$
####......##########.......######...............#
####......#........#.......#%%%%#...........#####
####......#........#..#....#%%%%#...........#####
####......####..####..#....##..##...........#####
####..................#.....................#####
#######################.....................#####
####........#&&&&&&#........####...######...#^^^^
####........#&&&&&&#.......#^^^^^^^^^^^^^#..#^^^^
####........###...##.......#^^^^^^^^^^^^^#..#^^^^
####..#####.................####...######...#^^^^
####..#@@@#.................................#^^^^
####..#.....................................##^^^
####################^^^...^^^^^^^^^^^^^^^^^^#####
^^^^^^^^^^^^^^^^^^^^^^^...^^^^^^^^^^^^^^^^^^^^###
########################$########################
2222222222222222222222222222222222222222222222222
2222666666666777777777777777777766666666666666666
6666000222222700000000700000007222222222222222226
6666000222222700000000700000007222222222222222226
6666000222222700000000700000007222222222222222226
6666000222222700000000777700777222222222222222226
6666000222222700000000700000000222222222222222226
6666666666006777007777700066666666666660006666666
6666000000000000000000000000000000000000000006666
6666000002222222222222000000000000000000000006666
6666000002222222222222000000000777777000000066666
6666000002222222222222000000000700007000000066666
6666000000000000000000000000000700777000000066666
6666000000000000000000000000000000000000000000001
6666000000777777777700000007777770000000000000006
6666000000700000000700000007111170000000000066666
6666000000700000000700600007111170000000000066666
6666000000777700777700700007700770000000000066666
6666000000000000000000600000000000000000000066666
6666666666667777776666600000000000000000000066666
6666000000007111111700000000666600066666600062222
6666000000007111111700000006222222222222260062222
6666000000007770007700000006222222222222260062222
6666007777700000000000000000666600066666600062222
6666007111700000000000000000000000000000000062222
6666007000000000000000000000000000000000000066222
6666666666666666666622200022222222222222222266666
2222222222222222222222200022222222222222222222666
6666666666666666666666661666666666666666666666666
2222222222222222222222222222222222222222222222222
2222111111111111111111111111111111111111111111111
1111000222222100000000100000001222222222222222221
1111000222222100000000100000001222222222222222221
1111000222222100000000100000001222222222222222221
1111000222222100000000111100111222222222222222221
1111000222222100000000100000000222222222222222221
1111111111001111001111100011111111111110001111111
1111000000000000000000000000000000000000000001111
1111000002222222222222000000000000000000000001111
1111000002222222222222000000000111111000000011111
1111000002222222222222000000000100001000000011111
1111000000000000000000000000000100111000000011111
1111000000000000000000000000000000000000000000003
1111000000111111111100000001111110000000000000001
1111000000100000000100000001444410000000000011111
1111000000100000000100100001444410000000000011111
1111000000111100111100100001100110000000000011111
1111000000000000000000100000000000000000000011111
1111111111111111111111100000000000000000000011111
1111000000001555555100000000111100011111100012222
1111000000001555555100000001222222222222210012222
1111000000001110001100000001222222222222210012222
1111001111100000000000000000111100011111100012222
1111001666100000000000000000000000000000000012222
1111001000000000000000000000000000000000000011222
1111111111111111111122200022222222222222222211111
2222222222222222222222200022222222222222222222111
1111111111111111111111113111111111111111111111111



