常青市
60,26
./0/空地,#/7/岩石,*/3/水域,^/2/草地,%/4/商店,&/5/医院,$/1/通往其他地区的出口,@/6/宝可梦中心
28/0/2/24/28,27/25/0/25/0
2/17/100,5/18/100,5/19/100,8/20/100,30/18/100,35/21/100,37/21/100,39/21/100,55/23/100,53/24/100
******######################$##############################
******#................^^....####........................##
******#...#############^^#...####......############......##
******#..#^^^^^^^^^^^^^^^#.............#...#......#......##
******#..#^^^^^^^^^^^^^^^#.............#..........#......##
******#..#^^^^^^^^^^^^^^^#...#.........#####.######......##
******#..#^^^^^^^^^^^^^^^#...#####.......................##
******#..#^^^^^^^^^^^^^^^#...#...#.......................##
******#..#^^^^^^^^^^^^^^^#...##.###########################
#######..#^^^^^^^^^^^^^^^#...............................##
#........#^^^^^^^^^^^^^^^#...............................##
#.........^^^^^^^^^^^^^^^....##############################
#............................#@@@#.......................##
#####........................##.##............#######....##
****#####.....................................#%%%%%#....##
****#^^^^....................#####...#####....#%%%%%#....##
****#^^^^#########...................#&&&#....##..###....##
****#^^^^#*******#....................&&&#...............##
****#^^^^#*******#...................#####...............##
###########*******##..#####...#############################
#^^^#.....................................................#
#^^^#.....................................................#
#^^^#######################...#############################
#^^^^^^^^^^^^^^^^^^#^^^^^^#...#^^^^^^#^^^^^^^^^^^^^^^^^^^^^
#^^^^^^^^^^^^^^^^^^#^^^^^^.....^^^^^^#^^^^^^^^^^^^^^^^^^^^^
###########################$##########^^^^^^^^^^^^^^^^^^^^^
33333377777777777777777777771777777777777777777777777777777
33333370000000000000000220000777700000000000000000000000077
33333370007777777777777227000777700000077777777777700000077
33333370072222222222222227000000000000070007000000700000077
33333370072222222222222227000000000000070000000000700000077
33333370072222222222222227000700000000077777077777700000077
33333370072222222222222227000777770000000000000000000000077
33333370072222222222222227000700070000000000000000000000077
33333370072222222222222227000770777777777777777777777777777
77777770072222222222222227000000000000000000000000000000077
70000000072222222222222227000000000000000000000000000000077
70000000002222222222222220000777777777777777777777777777777
70000000000000000000000000000766670000000000000000000000077
77777000000000000000000000000770770000000000007777777000077
33337777700000000000000000000000000000000000007444447000077
33337222200000000000000000000777770007777700007444447000077
33337222277777777700000000000000000007555700007700777000077
33337222273333333700000000000000000000555700000000000000077
33337222273333333700000000000000000007777700000000000000077
77777777777333333377007777700077777777777777777777777777777
72227000000000000000000000000000000000000000000000000000000
72227000000000000000000000000000000000000000000000000000000
72227777777777777777777777700077777777777777777777777777777
72222222222222222227222222700072222227222222222222222222222
72222222222222222227222222000002222227222222222222222222222
77777777777777777777777777717777777777222222222222222222222
11111111111111111111111111113111111111111111111111111111111
11111110000000000000000220000111100000000000000000000000011
11111110001111111111111221000111100000011111111111100000011
11111110012222222222222221000000000000010001000000100000011
11111110012222222222222221000000000000010000000000100000011
11111110012222222222222221000100000000011111011111100000011
11111110012222222222222221000111110000000000000000000000011
11111110012222222222222221000100010000000000000000000000011
11111110012222222222222221000110111111111111111111111111111
11111110012222222222222221000000000000000000000000000000011
10000000012222222222222221000000000000000000000000000000011
10000000002222222222222220000111111111111111111111111111111
10000000000000000000000000000166610000000000000000000000011
11111000000000000000000000000110110000000000001111111000011
11111111100000000000000000000000000000000000001444441000011
11111222200000000000000000000111110001111100001444441000011
11111222211111111100000000000000000001555100001100111000011
11111222211111111100000000000000000000555100000000000000011
11111222211111111100000000000000000001111100000000000000011
11111111111111111111001111100011111111111111111111111111111
12221000000000000000000000000000000000000000000000000000000
12221000000000000000000000000000000000000000000000000000000
12221111111111111111111111100011111111111111111111111111111
12222222222222222221222222100012222221222222222222222222222
12222222222222222221222222000002222221222222222222222222222
11111111111111111111111111131111111111222222222222222222222