常青市
60,26
./0/空地,#/1/岩石,*/2/水域,^/3/草地,%/0/商店,&/0/医院,$/0/通往其他地区的出口
28/0/2/24/28,27/25/0/25/0

******######################$##############################
******#................^^....####........................##
******#...#############^^#...####......############......##
******#..#^^^^^^^^^^^^^^^#.............#..........#......##
******#..#^^^^^^^^^^^^^^^#.............#..........#......##
******#..#^^^^^^^^^^^^^^^#...#.........#####..#####......##
******#..#^^^^^^^^^^^^^^^#...#####.......................##
******#..#^^^^^^^^^^^^^^^#...#...#.......................##
******#..#^^^^^^^^^^^^^^^#...##.###########################
#######..#^^^^^^^^^^^^^^^#...............................##
#........#^^^^^^^^^^^^^^^#...............................##
#.........^^^^^^^^^^^^^^^....##############################
#............................#@@@#.......................##
#####........................##.##............#######....##
****#####.....................................#%%%%%#....##
****#^^^^....................#####...#####....#%%%%%#....##
****#^^^^#########...................#&&&#....##..###....##
****#^^^^#*******#....................&&&#...............##
****#^^^^#*******#...................#####...............##
###########*******##..#####...#############################
#^^^#......................................................
#^^^#......................................................
#^^^#######################...#############################
#^^^^^^^^^^^^^^^^^^#^^^^^^#...#^^^^^^#^^^^^^^^^^^^^^^^^^^^^
#^^^^^^^^^^^^^^^^^^#^^^^^^.....^^^^^^#^^^^^^^^^^^^^^^^^^^^^
###########################$##########^^^^^^^^^^^^^^^^^^^^^
55555522222222222222222222221222222222222222222222222222222
55555520000000000000000220000222200000000000000000000000022
55555520002222222222222222000222200000022222222222200000022
55555520022222222222222222000000000000020000000000200000022
55555520022222222222222222000000000000020000000000200000022
55555520022222222222222222000200000000022222002222200000022
55555520022222222222222222000222220000000000000000000000022
55555520022222222222222222000200020000000000000000000000022
55555520022222222222222222000220222222222222222222222222222
22222220022222222222222222000000000000000000000000000000022
20000000022222222222222222000000000000000000000000000000022
20000000002222222222222220000222222222222222222222222222222
20000000000000000000000000000211120000000000000000000000022
22222000000000000000000000000220220000000000002222222000022
55552222200000000000000000000000000000000000002111112000022
55552222200000000000000000000222220002222200002111112000022
55552222222222222200000000000000000002111200002200222000022
55552222225555555200000000000000000000111200000000000000022
55552222225555555200000000000000000002222200000000000000022
22222222222555555522002222200022222222222222222222222222222
22222000000000000000000000000000000000000000000000000000000
22222000000000000000000000000000000000000000000000000000000
22222222222222222222222222200022222222222222222222222222222
22222222222222222222222222200022222222222222222222222222222
22222222222222222222222222000002222222222222222222222222222
22222222222222222222222222212222222222222222222222222222222
11111111111111111111111111113111111111111111111111111111111
11111110000000000000000220000111100000000000000000000000011
11111110001111111111111221000111100000011111111111100000011
11111110012222222222222221000000000000010000000000100000011
11111110012222222222222221000000000000010000000000100000011
11111110012222222222222221000100000000011111001111100000011
11111110012222222222222221000111110000000000000000000000011
11111110012222222222222221000100010000000000000000000000011
11111110012222222222222221000110111111111111111111111111111
11111110012222222222222221000000000000000000000000000000011
10000000012222222222222221000000000000000000000000000000011
10000000002222222222222220000111111111111111111111111111111
10000000000000000000000000000166610000000000000000000000011
11111000000000000000000000000110110000000000001111111000011
11111111100000000000000000000000000000000000001444441000011
11111222200000000000000000000111110001111100001444441000011
11111222211111111100000000000000000001555100001100111000011
11111222211111111100000000000000000000555100000000000000011
11111222211111111100000000000000000001111100000000000000011
11111111111111111111001111100011111111111111111111111111111
12221000000000000000000000000000000000000000000000000000000
12221000000000000000000000000000000000000000000000000000000
12221111111111111111111111100011111111111111111111111111111
12222222222222222221222222100012222221222222222222222222222
12222222222222222221222222000002222221222222222222222222222
11111111111111111111111111131111111111222222222222222222222