红莲岛
49,30
./0/空地,#/1/岩石,*/2/水域,^/3/草地,%/0/商店,&/0/医院,$/0/通往其他地区的出口
23/0/7/10/28

*****#*****************$******#******************
*****#****************#.#*****#******************
*****#****************#.#*****#******************
*****#****************#.#*****#******************
*****#****************#.#*****#******************
*****#****###########........##########**********
*****#****#.........#........#........#**********
*****#****#.........#........#........###########
*****#****#.........#........#........#**********
*****#****####...####........####...###**********
*****#****.............................**********
*****#****.............................**********
*****#****...............^^^^^^^^^.....**********
*****#****###########....^^^^^^^^^.....**********
*****#****#@@@@@@@@@#....^^^^^^^^^.....**********
*****#****#@@@@@@@@@#..................**********
*****#****#@@@@@@@@@#..................**********
*****#****####...####.#######.#######..**********
*****#****............#&&&&&#.#%%%%%#..**********
*****#****............#&&&&&#.#%%%%%#..**********
*****#****............###..##.###..##..**********
*****#********.........................**********
*****#********.........................**********
*****#*******************************************
*****#*******************************************
*****#*******************************************
*****############################################
*************************************************
*************************************************
*************************************************
5555575555555555555555515555557555555555555555555
5555575555555555555555505555557555555555555555555
5555575555555555555555505555557555555555555555555
555557555555555555555550555557555555555555555555
5555575555555555555555505555557555555555555555555
5555575555777777777770000000077777777775555555555
5555575555700000000070000000070000000075555555555
5555575555700000000070000000070000000077777777777
5555575555700000000070000000070000000075555555555
5555575555777700077770000000077770007775555555555
5555575555000000000000000000000000000005555555555
5555575555000000000000000000000000000005555555555
5555575555000000000000000222222222000005555555555
5555575555777777777770000222222222000005555555555
5555575555711111111170000222222222000005555555555
5555575555711111111170000000000000000005555555555
5555575555711111111170000000000000000005555555555
5555575555777700077770777777707777777005555555555
5555575555000000000000711111707111117005555555555
5555575555000000000000711111707111117005555555555
5555575555000000000000777007707770077005555555555
5555575555555500000000000000000000000005555555555
5555575555555500000000000000000000000005555555555
5555575555555555555555555555555555555555555555555
5555575555555555555555555555555555555555555555555
5555575555555555555555555555555555555555555555555
5555577777777777777777777777777777777777777777777
5555555555555555555555555555555555555555555555555
5555555555555555555555555555555555555555555555555
5555555555555555555555555555555555555555555555555
1111111111111111111111131111111111111111111111111
1111111111111111111111101111111111111111111111111
1111111111111111111111101111111111111111111111111
1111111111111111111111101111111111111111111111111
1111111111111111111111101111111111111111111111111
1111111111111111111110000000011111111111111111111
1111111111100000000010000000010000000011111111111
1111111111100000000010000000010000000011111111111
1111111111100000000010000000010000000011111111111
1111111111111100011110000000011110001111111111111
1111111111000000000000000000000000000001111111111
1111111111000000000000000000000000000001111111111
1111111111000000000000000222222222000001111111111
1111111111111111111110000222222222000001111111111
1111111111166666666610000222222222000001111111111
1111111111166666666610000000000000000001111111111
1111111111166666666610000000000000000001111111111
1111111111111100011110111111101111111001111111111
1111111111000000000000155555101444441001111111111
1111111111000000000000155555101444441001111111111
1111111111000000000000111001101110011001111111111
1111111111111100000000000000000000000001111111111
1111111111111100000000000000000000000001111111111
1111111111111111111111111111111111111111111111111
1111111111111111111111111111111111111111111111111
1111111111111111111111111111111111111111111111111
1111111111111111111111111111111111111111111111111
1111111111111111111111111111111111111111111111111
1111111111111111111111111111111111111111111111111
1111111111111111111111111111111111111111111111111

