华蓝市
60,30
./0/空地,#/7/岩石,*/3/水域,^/2/草地,%/4/商店,&/5/医院,$/1/通往其他地区的出口,@/6/宝可梦中心
0/17/2/48/13,25/29/4/25/0
37/6/100,39/28/100,40/26/100,43/12/100,44/47/100,39/43/100,38/36/100,40/40/100
***********************#######*****************************
###################****......#*****************************
####*******************......#*****************************
####*******************......##############################
####*##################......##############################
####*##################......##############################
####*#^^^^^^^^^^^^^^^^#......###...#^^^^^^^^^^^^^^^^#######
####*#^^^^^^...................#...#^^^^^^^^^^^^^^^^#######
##***#^^^^^^...................##.##^^^^^^^^^^^^^^^^#######
##***#^^^^^^^^^^^^^^^^................................#^^^^
*****##################...............................#^^^^
*****#.........#@@@@@@#...............................#^^^^
*****###..########..###...............................#^^^^
*****#................................####...####.....#^^^^
*****#...........##..##....#######....#.........#.....#^^^^
*****#...........#....#....#&&&&&#....#.........#.....#^^^^
#######################....##..###....###########.....#####
$.........................................................#
#######...^^^^^^^^^^^^^^^^^^^.............................#
^^^^^#^...^^^^^^^^^^^^^^^^^^^..........^^^^^^^^^^^^^..#####
^^^^^#^...#######..............###..###^^^^^^^^^^^^^..#^^^^
^^^^^#^...#.....#...##..#####..#%%%%%%#.....###..###..#^^^^
^^^^^#^...#.....#...#.......#..#%%%%%%#.....#......#..#^^^^
^^^^^#^...##..###...#########..########.....########..#^^^^
^^^^^#^...............................................#^^^^
^^^^^###################....#######################...#^^^^
^^^^^#^...............................................#^^^^
^^^^^#^.....................^^^^^^^^^^^...............#^^^^
^^^^^^^^^^^^^^^^^^^^^^^#...#^^^^^^^^^^^....############^^^^
^^^^^^^^^^^^^^^^^^^^^^^##$#################################
33333333333333333333333777777733333333333333333333333333333
77777777777777777773333000000733333333333333333333333333333
77773333333333333333333000000733333333333333333333333333333
77773333333333333333333000000777777777777777777777777777777
77773777777777777777777000000777777777777777777777777777777
77773777777777777777777000000777777777777777777777777777777
77773722222222222222222000000777000722222222222222227777777
77773722222200000000000000000007000722222222222222227777777
77333722222200000000000000000007707722222222222222227777777
77333722222222222222220000000000000000000000000000000072222
33333777777777777777777000000000000000000000000000000072222
33333700000000076666667000000000000000000000000000000072222
33333777007777777700777000000000000000000000000000000072222
33333700000000000000000000000000000000777700077770000072222
33333700000000000770077000077777770000700000000070000072222
33333700000000000700007000075555570000700000000070000072222
77777777777777777777777000077007770000777777777770000077777
10000000000000000000000000000000000000000000000000000000007
77777770002222222222222222222000000000000000000000000000007
22222720002222222222222222222000000000022222222222220077777
22222720007777777000000000000007770077722222222222220072222
22222720007000007000770077777007444444700000777007770072222
22222720007000007000700000007007444444700000700000070072222
22222720007700777000777777777007777777700000777777770072222
22222720000000000000000000000000000000000000000000000072222
22222777777777777777777700007777777777777777777777700072222
22222720000000000000000000000000000000000000000000000072222
22222720000000000000000000002222222222200000000000000072222
22222222222222222222222700072222222222200007777777777772222
22222222222222222222222771777777777777777777777777777777777
11111111111111111111111111111111111111111111111111111111111
11111111111111111111111000000111111111111111111111111111111
11111111111111111111111000000111111111111111111111111111111
11111111111111111111111000000111111111111111111111111111111
11111111111111111111111000000111111111111111111111111111111
11111111111111111111111000000111111111111111111111111111111
11111122222222222222221000000111000122222222222222221111111
11111122222200000000000000000001000122222222222222221111111
11111122222200000000000000000001101122222222222222221111111
11111122222222222222220000000000000000000000000000000012222
11111111111111111111111000000000000000000000000000000012222
11111100000000016666661000000000000000000000000000000012222
11111111001111111100111000000000000000000000000000000012222
11111100000000000000000000000000000000111100011110000012222
11111100000000000110011000011111110000100000000010000012222
11111100000000000100001000013333310000100000000010000012222
11111111111111111111111000011001110000111111111110000011111
30000000000000000000000000000000000000000000000000000000001
11111110002222222222222222222000000000000000000000000000001
22222120002222222222222222222000000000022222222222220011111
22222120001111111000000000000001110011122222222222220012222
22222120001000001000110011111001444444100000111001110012222
22222120001000001000100000001001444444100000100000010012222
22222120001100111000111111111001111111100000111111110012222
22222120000000000000000000000000000000000000000000000012222
22222111111111111111111100001111111111111111111111100012222
22222120000000000000000000000000000000000000000000000012222
22222120000000000000000000002222222222200000000000000012222
22222222222222222222222100012222222222200001111111111112222
22222222222222222222222113111111111111111111111111111111111

