红莲岛
49,30
./0/空地,#/7/岩石,*/3/水域,^/2/草地,%/4/商店,&/5/医院,$/1/通往其他地区的出口,@/6/宝可梦中心
23/0/7/10/28
96/50/100,98/48/100,106/43/100,109/38/100,112/40/100,116/50/100,114/45/100,119/26/100,124/43/100
*****#*****************$******#******************
*****#****************#.#*****#******************
*****#****************#.#*****#******************
*****#****************#.#*****#******************
*****#****************#.#*****#******************
*****#****###########........##########**********
*****#****#.........#........#........#**********
*****#****#.........#........#........###########
*****#****#.........#........#........#**********
*****#****####...####........####...###**********
*****#****.............................**********
*****#****.............................**********
*****#****...............^^^^^^^^^.....**********
*****#****###########....^^^^^^^^^.....**********
*****#****#@@@@@@@@@#....^^^^^^^^^.....**********
*****#****#@@@@@@@@@#..................**********
*****#****#@@@@@@@@@#..................**********
*****#****####...####.#######.#######..**********
*****#****............#&&&&&#.#%%%%%#..**********
*****#****............#&&&&&#.#%%%%%#..**********
*****#****............###..##.###..##..**********
*****#********.........................**********
*****#********.........................**********
*****#*******************************************
*****#*******************************************
*****#*******************************************
*****############################################
*************************************************
*************************************************
*************************************************
3333373333333333333333313333337333333333333333333
3333373333333333333333703333337333333333333333333
3333373333333333333333703333337333333333333333333
3333373333333333333333703333337333333333333333333
3333373333333333333333703333337333333333333333333
3333373333777777777770000000077777777773333333333
3333373333700000000070000000070000000073333333333
3333373333700000000070000000070000000077777777777
3333373333700000000070000000070000000073333333333
3333373333777700077770000000077770007773333333333
3333373333000000000000000000000000000003333333333
3333373333000000000000000000000000000003333333333
3333373333000000000000000222222222000003333333333
3333373333777777777770000222222222000003333333333
3333373333766666666670000222222222000003333333333
3333373333766666666670000000000000000003333333333
3333373333766666666670000000000000000003333333333
3333373333777700077770777777707777777003333333333
3333373333000000000000755555707444447003333333333
3333373333000000000000755555707444447003333333333
3333373333000000000000777007707770077003333333333
3333373333333300000000000000000000000003333333333
3333373333333300000000000000000000000003333333333
3333373333333333333333333333333333333333333333333
3333373333333333333333333333333333333333333333333
3333373333333333333333333333333333333333333333333
3333377777777777777777777777777777777777777777777
3333333333333333333333333333333333333333333333333
3333333333333333333333333333333333333333333333333
3333333333333333333333333333333333333333333333333
1111111111111111111111131111111111111111111111111
1111111111111111111111101111111111111111111111111
1111111111111111111111101111111111111111111111111
1111111111111111111111101111111111111111111111111
1111111111111111111111101111111111111111111111111
1111111111111111111110000000011111111111111111111
1111111111100000000010000000010000000011111111111
1111111111100000000010000000010000000011111111111
1111111111100000000010000000010000000011111111111
1111111111111100011110000000011110001111111111111
1111111111000000000000000000000000000001111111111
1111111111000000000000000000000000000001111111111
1111111111000000000000000222222222000001111111111
1111111111111111111110000222222222000001111111111
1111111111166666666610000222222222000001111111111
1111111111166666666610000000000000000001111111111
1111111111166666666610000000000000000001111111111
1111111111111100011110111111101111111001111111111
1111111111000000000000155555101444441001111111111
1111111111000000000000155555101444441001111111111
1111111111000000000000111001101110011001111111111
1111111111111100000000000000000000000001111111111
1111111111111100000000000000000000000001111111111
1111111111111111111111111111111111111111111111111
1111111111111111111111111111111111111111111111111
1111111111111111111111111111111111111111111111111
1111111111111111111111111111111111111111111111111
1111111111111111111111111111111111111111111111111
1111111111111111111111111111111111111111111111111
1111111111111111111111111111111111111111111111111

