玉虹市
50,30
./0/空地,#/1/岩石,*/2/水域,^/3/草地,%/0/商店,&/0/医院,$/0/通往其他地区的出口
48/10/4/0/19

#################################################
#################################################
##%%%%%%%%#^^^^^^^^^^^^^^^^^^^^^^^^^^^^^^^^^^####
##%%%%%%%%#^^^^^^^^^^^^^^^^^^^^^^^^^^^^^^^^^^####
##%%%%%%%%######...######.................^^^####
##%%%%%%%%#....#...#....#.####.####.####..^^^####
##%%%%%%%%#....#...#....#.#..#.#..#.#&&#..^^^####
##%%%%%%%%#....#...#....#.#..#.#..#.#&&#..^^^####
#####..#########...##..##.####.####.#..#..^^^####
##..............................................#
##..............................................$
##..............................................#
##.........***.#######.#####...####.####...######
##.........***.#.....#.#@@@#...#..#.#..#...######
##.........***.##..###.#...#...####.####...######
##.........***...............................####
##...........................................####
##...........................................####
#............................................####
########.################...####.####.####...####
##.....#.#.........#....#...#..#.#..#.#..#...####
##.....#.#.........#....#...#..#.#..#.#..#...####
####..##.#####..#########...####.#..#.####...####
##...........................................####
##...........................................####
######..#########............................####
##^^^^^^^^^^^^^^^^^^^^^^^^^^^^^^^^^^^^^^^^^^^^^##
##^^^^^^^^^^^^^^^^^^^^^^^^^^^^^^^^^^^^^^^^^^^^^##
#################################################
#################################################
2222222222222222222222222222222222222222222222222
2777777722222222222222222222222222222222222222222
2711111111722222222222222222222222222222222222222
2711111111722222222222222222222222222222222222222
2711111111777777000777777000000000000000002222222
2711111111700007000700007077770777707777002222222
2711111111700007000700007070070700707117002222222
2711111111700007000700007070070700707117002222222
7777700777777777000770077077770777707007002222222
2200000000000000000000000000000000000000000000007
2200000000000000000000000000000000000000000000001
2200000000000000000000000000000000000000000000007
2200000000055507777777077777000777707777000222222
2200000000055507000007071117000700707007000222222
2200000000055507700777070007000777707777000222222
2200000000055500000000000000000000000000000002222
2200000000000000000000000000000000000000000002222
2200000000000000000000000000000000000000000002222
2000000000000000000000000000000000000000000002222
2777777707777777777777777000777707777077770002222
2700000707000000000700007000700707007070070002222
2700000707000000000700007000700707007070070002222
2777007707777700777777777000777707007077770002222
2700000000000000000000000000000000000000000002222
2700000000000000000000000000000000000000000002222
2222220077777777700000000000000000000000000002222
2222222222222222222222222222222222222222222222222
2222222222222222222222222222222222222222222222222
2222222222222222222222222222222222222222222222222
2222222222222222222222222222222222222222222222222
1111111111111111111111111111111111111111111111111
1111111111111111111111111111111111111111111111111
1144444444122222222222222222222222222222222221111
1144444444122222222222222222222222222222222221111
1144444444111111000111111000000000000000002221111
1144444444100001000100001011110111101111002221111
1144444444100001000100001010010100101551002221111
1144444444100001000100001010010100101551002221111
1111100111111111000110011011110111101001002221111
1100000000000000000000000000000000000000000000001
1100000000000000000000000000000000000000000000003
1100000000000000000000000000000000000000000000001
1100000000011101111111011111000111101111000111111
1100000000011101000001016661000100101001000111111
1100000000011101100111010001000111101111000111111
1100000000011100000000000000000000000000000001111
1100000000000000000000000000000000000000000001111
1100000000000000000000000000000000000000000001111
1000000000000000000000000000000000000000000001111
1111111101111111111111111000111101111011110001111
1100000101000000000100001000100101001010010001111
1100000101000000000100001000100101001010010001111
1111001101111100111111111000111101001011110001111
1100000000000000000000000000000000000000000001111
1100000000000000000000000000000000000000000001111
1111110011111111100000000000000000000000000001111
1122222222222222222222222222222222222222222222211
1122222222222222222222222222222222222222222222211
1111111111111111111111111111111111111111111111111
1111111111111111111111111111111111111111111111111