浅红镇
49,29
./0/空地,#/1/岩石,*/2/水域,^/3/草地,%/0/商店,&/0/医院,$/0/通往其他地区的出口
0/16/5/48/8,10/28/8/23/0

#################################################
######^^^^^^#######.#......######################
##^^^^^^^^^^#######.#......######^^^^^^^^^^^#####
##^^##########^^#^^.#############^^^^^^^^^^^#####
##^^#******###^^#^^#........##.....^^^^^^^^^^####
##^^#******###^^#^^#........##.....^^^^^^^^^^^###
##^^#...^^^^##^^^^^#...........................##
##^^^...^^^^^^^^^^^#...............##############
##^^^#######^^^^^^^#....########...^^^^^^^^^^^###
##^^^#%%%%%#########....#......#...^^^^^^^^^^^###
##^^^#%%%%%#............#......#...^^^^^^^^^^^###
##^^^##..###........^^^####..###....########...##
##..................^^^#...........#********#..##
####################^^^#...........#********#..##
######************##^^^#...........#********#..##
######************######.......########........##
$..............................#@@@@@@#........##
#..##########################..#@@@@@@#######..##
#..##########################..#@@@@@@#.....#..##
#..##########################..###..#########..##
#..#.#........#.....#.#######..................##
#..#.#........###..##.#&&&&&#....^^^^^^^^......##
#..#.####...###.......###..##....^^^^^^^^......##
#..#.............................^^^^^^^^......##
#..#######.....#############...................##
#..............#######.........................##
#######........#######^^^^^^^^^^^^^^^^^^^^^^^^^##
#######........##################################
##########$######################################
2222222222222222222277777777222222222222222222222
2222222222222222222070000007222222222222222222222
2222222222222222222070000007222222222222222222222
22222222222222222220777777777222222222222222222222
2222255555522222222200000000220000022222222222222
2222255555522222222200000000220000022222222222222
2222200022222222222200000000000000000000000000022
2222200022222222222200000000000000022222222222222
2222277777772222222200007777777700022222222222222
2222271111172222222200007000000700022222222222222
2222271111170000000000007000000700022222222222222
222227007770000000022277770072200002222222200022
2200000000000000000022220000000000025555555520022
2222222222222222222222220000000000025555555520022
2222225555555555552222220000000000025555555520022
2222225555555555552222220000000111111110000000022
1000000000000000000000000000000111111110000000022
2002222222222222222222222222200111111111111110022
2002222222222222222222222222200111111110000010022
2002211111111111111112222222200111001111111110022
2002010000000010000010111111100000000000000000022
2002010000000011100110111111100002222222200000022
2002011110001110000000111001100002222222200000022
2002000000000000000000000000000002222222200000022
2002222222000002222222222222000000000000000000022
2000000000000002222222000000000000000000000000022
2222222000000002222222222222222222222222222222222
2222222000000002222222222222222222222222222222222
2222222222122222222222222222222222222222222222222
1111111111111111111111111111111111111111111111111
1111112222221111111010000001111111111111111111111
1122222222221111111010000001111112222222222211111
1122111111111122122011111111111112222222222211111
1122111111111122122100000000110000022222222221111
1122111111111122122100000000110000022222222222111
1122100022221122222100000000000000000000000000011
1122200022222222222100000000000000011111111111111
1122211111112222222100001111111100022222222222111
1122214444411111111100001000000100022222222222111
1122214444410000000000001000000100022222222222111
1122211001110000000022211110011100001111111100011
1100000000000000000022210000000000011111111110011
1111111111111111111122210000000000011111111110011
1111111111111111111122210000000000011111111110011
1111111111111111111111110000000111111110000000011
3000000000000000000000000000000166666610000000011
1001111111111111111111111111100166666611111110011
1001111111111111111111111111100166666610000010011
1001111111111111111111111111100111001111111110011
1001010000000010000010111111100000000000000000011
1001010000000011100110155555100002222222200000011
1001011110001110000000111001100002222222200000011
1001000000000000000000000000000002222222200000011
1001111111000001111111111111000000000000000000011
1000000000000001111111000000000000000000000000011
1111111000000001111111222222222222222222222222211
1111111000000001111111111111111111111111111111111
1111111111311111111111111111111111111111111111111