华蓝市
59,30
./0/空地，#/1/岩石，^/2/水域，^/3草地，%/0/商店，&/0/医院，$/0/通往其他地区的出口
0/17/2/48/13

^^^^^^^^^^^^^^^^^^^^^^^#######^^^^^^^^^^^^^^^^^^^^^^^^^^^^^
###################^^^^......#^^^^^^^^^^^^^^^^^^^^^^^^^^^^^
####^^^^^^^^^^^^^^^^^^^......#^^^^^^^^^^^^^^^^^^^^^^^^^^^^^
####^^^^^^^^^^^^^^^^^^^......##############################
####^##################......##############################
####^##################......##############################
####^#^^^^^^^^^^^^^^^^#......###...#^^^^^^^^^^^^^^^^#######
####^#^^^^^^...................#...#^^^^^^^^^^^^^^^^#######
##^^^#^^^^^^...................##.##^^^^^^^^^^^^^^^^#######
##^^^#^^^^^^^^^^^^^^^^................................#^^^^
^^^^^##################...............................#^^^^
^^^^^#.........#@@@@@@#...............................#^^^^
^^^^^###..########..###...............................#^^^^
^^^^^#................................####...####.....#^^^^
^^^^^#...........##..##....#######....#.........#.....#^^^^
^^^^^#...........#....#....#&&&&&#....#.........#.....#^^^^
#######################....##..###....###########.....#####
$.........................................................#
#######...^^^^^^^^^^^^^^^^^^^.............................#
^^^^^#^...^^^^^^^^^^^^^^^^^^^..........^^^^^^^^^^^^^..#####
^^^^^#^...#######..............###..###^^^^^^^^^^^^^..#^^^^
^^^^^#^...#.....#...##..#####..#%%%%%%#.....###..###..#^^^^
^^^^^#^...#.....#...#.......#..#%%%%%%#.....#......#..#^^^^
^^^^^#^...##..###...#########..########.....########..#^^^^
^^^^^#^...............................................#^^^^
^^^^^###################....#######################...#^^^^
^^^^^#^...............................................#^^^^
^^^^^#^.....................^^^^^^^^^^^...............#^^^^
^^^^^^^^^^^^^^^^^^^^^^^#...#^^^^^^^^^^^....############^^^^
^^^^^^^^^^^^^^^^^^^^^^^##$#################################
55555555555555555555555222222255555555555555555555555555555
22222222222222222225555000000255555555555555555555555555555
22225555555555555555555000000255555555555555555555555555555
22225555555555555555555000000222222222222222222222222222222
22225222222222222222222000000222222222222222222222222222222
22225222222222222222222000000223333322222222222222222222222
22225222222222222222222000000223000322222222222222222222222
22225222222200000000000000000003000322222222222222222222222
22555222222200000000000000000003303322222222222222222222222
22555222222222222222220000000000000000000000000000000022222
55555333333333333333333000000000000000000000000000000022222
55555300000000031111113000000000000000000000000000000022222
55555333003333333300333000000000000000000000000000000022222
55555200000000000000000000000000000000333300033330000022222
55555200000000000330033000033333330000300000000030000022222
55555200000000000300003000031111130000300000000030000022222
22222222222222222333333000033003330000333333333330000022222
10000000000000000000000000000000000000000000000000000000002
22222220002222222222222222222000000000000000000000000000002
22222220002222222222222222222000000000022222222222220022222
22222220003333333000000000000003330033322222222222220022222
22222220003000003000330033333003111111300000333003330022222
22222220003000003000300000003003111111300000300000030022222
22222220003300333000333333333003333333300000333333330022222
22222220000000000000000000000000000000000000000000000022222
22222222222222222222222200002222222222222222222222200022222
22222220000000000000000000000000000000000000000000000022222
22222220000000000000000000002222222222200000000000000022222
22222222222222222222222200022222222222200002222222222222222
22222222222222222222222221222222222222222222222222222222222
11111111111111111111111111111111111111111111111111111111111
11111111111111111111111000000111111111111111111111111111111
11111111111111111111111000000111111111111111111111111111111
11111111111111111111111000000111111111111111111111111111111
11111111111111111111111000000111111111111111111111111111111
11111111111111111111111000000111111111111111111111111111111
11111122222222222222221000000111000122222222222222221111111
11111122222200000000000000000001000122222222222222221111111
11111122222200000000000000000001101122222222222222221111111
11111122222222222222220000000000000000000000000000000012222
11111111111111111111111000000000000000000000000000000012222
11111100000000016666661000000000000000000000000000000012222
11111111001111111100111000000000000000000000000000000012222
11111100000000000000000000000000000000111100011110000012222
11111100000000000110011000011111110000100000000010000012222
11111100000000000100001000015555510000100000000010000012222
11111111111111111111111000011001110000111111111110000011111
30000000000000000000000000000000000000000000000000000000001
11111110002222222222222222222000000000000000000000000000001
22222120002222222222222222222000000000022222222222220011111
22222120001111111000000000000001110011122222222222220012222
22222120001000001000110011111001444444100000111001110012222
22222120001000001000100000001001444444100000100000010012222
22222120001100111000111111111001111111100000111111110012222
22222120000000000000000000000000000000000000000000000012222
22222111111111111111111100001111111111111111111111100012222
22222120000000000000000000000000000000000000000000000012222
22222120000000000000000000002222222222200000000000000012222
22222222222222222222222100012222222222200001111111111112222
22222222222222222222222113111111111111111111111111111111111

