金黄市
50,30
./0/空地,#/1/岩石,*/2/水域,^/3/草地,%/0/商店,&/0/医院,$/0/通往其他地区的出口
25/0/3/25/29,0/19/6/48/10,24/29/5/24/0

^^^^^^#########.####.####$########.############^#
^^^^^^#.......#.#..#.#..#.#@@@@@@#.#.........#.^#
......####..###.####.#..#.#####..#.#####..####.^#
##########.....................................^#
^^^^^^^^^#.....................................^#
##########...##..######....######...########...^#
#^#............................................^#
#^#.##########################################.^#
#^#.#....#...#...#...#...#%%%%%#...#....#....#.^#
#^#.#....#...#...#...#...#%%%%%#...#....#....#.^#
#^#.######.###############..##################.^#
#^#............................................^#
#^#.##########################################.^#
#^#.#....#....#....................#....#....#.^#
#^#.#....#....#....................#....#....#.^#
#^#.#....#....#....................#....#....#.^#
#^#.#....#....#....................#....#....#.^#
#^#.#....#....#....................#....#....#..#
###.#....#....#....................#....#....#.^#
$...#....#....#....................#....#....#.^#
###.#################....#####################.^#
#^#............................................^#
#^#.##########################################.^#
#^#.#....#&&&&#....#....#....#....#.....#....#.^#
#^#.#....#&&&&#....#....#....#....#.....#....#.^#
###.#....#&&&&#....#....#....#....#.....#....#.^#
^^#.#....#&&&&#....#....#....#....#.....#....#.^#
^^#.#######..#######################..########.^#
^^#............................................^#
^^######################$######################^#
2222227777777770777707777144444444044444444444727
2222227000000070700707007041111114040000000004027
0000007777007770777707007044444004044444004444027
7777777777000000000000000000000000000000000000027
2222222227000000000000000000000000000000000000027
7777777777000770077777700007777770007777777700027
7270000000000000000000000000000000000000000000027
7270777777777777777777777777777777777777777777027
7270700007000700070007000711111700070000700007027
7270700007000700070007000711111700070000700007027
7270777777077777777777777700777777777777777777027
7270000000000000000000000000000000000000000000027
7270777777777777777777777777777777777777777777027
7270700007000070000000000000000000070000700007027
7270700007000070000000000000000000070000700007027
7270700007000070000000000000000000070000700007027
7270700007000070000000000000000000070000700007027
7270700007000070000000000000000000070000700007007
7770700007000070000000000000000000070000700007027
1000700007000070000000000000000000070000700007027
7770777777777777777770000777777777777777777777027
7270000000000000000000000000000000000000000000027
7270777777777777777777777777777777777777777777027
7270700007111170000700007000070000700000700007027
7270700007111170000700007000070000700000700007027
7770700007111170000700007000070000700000700007027
2270700007111170000700007000070000700000700007027
2270777777700777777777777777777777770077777777027
2270000000000000000000000000000000000000000000027
2277777777777777777777771777777777777777777777727
2222221111111110111101111311111111011111111111121
2222221000000010100101001016666661010000000001021
0000001111001110111101001011111001011111001111021
1111111111000000000000000000000000000000000000021
2222222221000000000000000000000000000000000000021
1111111111000110011111100001111110001111111100021
1210000000000000000000000000000000000000000000021
1210111111111111111111111111111111111111111111021
1210100001000100010001000144444100010000100001021
1210100001000100010001000144444100010000100001021
1210111111011111111111111100111111111111111111021
1210000000000000000000000000000000000000000000021
1210111111111111111111111111111111111111111111021
1210100001000010000000000000000000010000100001021
1210100001000010000000000000000000010000100001021
1210100001000010000000000000000000010000100001021
1210100001000010000000000000000000010000100001021
1210100001000010000000000000000000010000100001001
1110100001000010000000000000000000010000100001021
3000100001000010000000000000000000010000100001021
1110111111111111111110000111111111111111111111021
1210000000000000000000000000000000000000000000021
1210111111111111111111111111111111111111111111021
1210100001555510000100001000010000100000100001021
1210100001555510000100001000010000100000100001021
1110100001555510000100001000010000100000100001021
2210100001555510000100001000010000100000100001021
2210111111100111111111111111111111110011111111021
2210000000000000000000000000000000000000000000021
2211111111111111111111113111111111111111111111121